NO textures/netherite.png
SO textures/I.png
EA textures/D.png
WE textures/O.png
F 85,85,85
C 135,206,235

11111111111111
1     W       1
1             1
1111111111111111
111111111111111111
111111111111111111
111111111111111111
111111111111111111
